slug	local_name	qualified_name
alconbury-brook	Alconbury Brook	Alconbury Brook
aldford-brook	Aldford Brook	Aldford Brook
aldingbourne-rife	Aldingbourne Rife	Aldingbourne Rife
aller-brook	Aller Brook	Aller Brook
allison-dike	Allison Dike	Allison Dike
alverthorpe-beck	Alverthorpe Beck	Alverthorpe Beck
alwen	Alwen	Alwen
alyn	Alyn	Alyn
ampney-brook	Ampney Brook	Ampney Brook
arkle-beck	Arkle Beck	Arkle Beck
arrowe-brook	Arrowe Brook	Arrowe Brook
ashbrooke	Ashbrooke	Ashbrooke
atherfield-brook	Atherfield Brook	Atherfield Brook
babingley-river	Babingley River	Babingley River
back-delfin	Back Delfin	Back Delfin
badsey-brook	Badsey Brook	Badsey Brook
bagley-brook	Bagley Brook	Bagley Brook
bagley-dike	Bagley Dike	Bagley Dike
baguley-brook	Baguley Brook	Baguley Brook
baildon-dike	Baildon Dike	Baildon Dike
balne-beck	Balne Beck	Balne Beck
barbourne-brook	Barbourne Brook	Barbourne Brook
bardsey-beck	Bardsey Beck	Bardsey Beck
barge-canal	Barge Canal	Barge Canal
barlings-eau	Barlings Eau	Barlings Eau
barmston-drain	Barmston Drain	Barmston Drain
barnham-rife	Barnham Rife	Barnham Rife
bartley-water	Bartley Water	Bartley Water
barton-haven	Barton Haven	Barton Haven
batley-beck	Batley Beck	Batley Beck
bear-brook	Bear Brook	Bear Brook
beaulieu-river	Beaulieu River	Beaulieu River
bechan-brook	Bechan Brook	Bechan Brook
bedale-beck	Bedale Beck	Bedale Beck
bedburn-beck	Bedburn Beck	Bedburn Beck
beverley-brook	Beverley Brook	Beverley Brook
bickerly-mill-stream	Bickerly Mill Stream	Bickerly Mill Stream
bielby-beck	Bielby Beck	Bielby Beck
billinghay-skirth	Billinghay Skirth	Billinghay Skirth
bin-brook	Bin Brook	Bin Brook
bishop-monkton-beck	Bishop Monkton Beck	Bishop Monkton Beck
black-brook-leicestershire	Black Brook	Black Brook (Leicestershire)
black-brook-yorkshire	Black Brook	Black Brook (Yorkshire)
blackburn-brook	Blackburn Brook	Blackburn Brook
blackfoss-beck	Blackfoss Beck	Blackfoss Beck
blacup-beck	Blacup Beck	Blacup Beck
bloxham-brook	Bloxham Brook	Bloxham Brook
blue-beck	Blue Beck	Blue Beck
bodmin-town-leat	Bodmin Town Leat	Bodmin Town Leat
bolingey-stream	Bolingey Stream	Bolingey Stream
bosham-stream	Bosham Stream	Bosham Stream
bottle-brook	Bottle Brook	Bottle Brook
boundary-brook	Boundary Brook	Boundary Brook
bourn-brook	Bourn Brook	Bourn Brook
bourne-brook	Bourne Brook	Bourne Brook
bourne-rivulet	Bourne Rivulet	Bourne Rivulet
bow-brook	Bow Brook	Bow Brook
bowmont-water	Bowmont Water	Bowmont Water
bradford-beck	Bradford Beck	Bradford Beck
bradiford-water	Bradiford Water	Bradiford Water
bradley-brook	Bradley Brook	Bradley Brook
bramham-beck	Bramham Beck	Bramham Beck
brampton-beck	Brampton Beck	Brampton Beck
brampton-branch	Brampton Branch	Brampton Branch
bridgehouse-beck	Bridgehouse Beck	Bridgehouse Beck
brinkworth-brook	Brinkworth Brook	Brinkworth Brook
brislington-brook	Brislington Brook	Brislington Brook
broad-fleet	Broad Fleet	Broad Fleet
brompton-beck	Brompton Beck	Brompton Beck
brook-dike	Brook Dike	Brook Dike
brough-beck	Brough Beck	Brough Beck
broughton-beck	Broughton Beck	Broughton Beck
broughton-brook	Broughton Brook	Broughton Brook
browney-dyke	Browney Dyke	Browney Dyke
brownwich-stream	Brownwich Stream	Brownwich Stream
buck-beck	Buck Beck	Buck Beck
budleigh-brook	Budleigh Brook	Budleigh Brook
bulstake-stream	Bulstake Stream	Bulstake Stream
bumpstead-brook	Bumpstead Brook	Bumpstead Brook
burn-valley-beck	Burn Valley Beck	Burn Valley Beck
burrow-beck	Burrow Beck	Burrow Beck
burstow-stream	Burstow Stream	Burstow Stream
burstwick-drain	Burstwick Drain	Burstwick Drain
bury-brook	Bury Brook	Bury Brook
bushy-beck	Bushy Beck	Bushy Beck
by-brook	By Brook	By Brook
caker-stream	Caker Stream	Caker Stream
camlad	Camlad	Camlad
candover-stream	Candover Stream	Candover Stream
canley-brook	Canley Brook	Canley Brook
cannington-brook	Cannington Brook	Cannington Brook
cannon-brook	Cannon Brook	Cannon Brook
canons-brook	Canons Brook	Canons Brook
carnon-river	Carnon River	Carnon River
carr-brook	Carr Brook	Carr Brook
catcliffe-drain	Catcliffe Drain	Catcliffe Drain
ceiriog	Ceiriog	Ceiriog
chad-brook	Chad Brook	Chad Brook
chalgrove-brook	Chalgrove Brook	Chalgrove Brook
charlton-brook	Charlton Brook	Charlton Brook
cheddar-yeo	Cheddar Yeo	Cheddar Yeo
cheriton-stream	Cheriton Stream	Cheriton Stream
chew-stoke-brook	Chew Stoke Brook	Chew Stoke Brook
ching-brook	Ching Brook	Ching Brook
chitterne-brook	Chitterne Brook	Chitterne Brook
church-beck	Church Beck	Church Beck
clackers-brook	Clackers Brook	Clackers Brook
clanfield-brook	Clanfield Brook	Clanfield Brook
clay-coton-brook	Clay Coton Brook	Clay Coton Brook
clennon-valley-watercourse	Clennon Valley Watercourse	Clennon Valley Watercourse
clipstone-brook	Clipstone Brook	Clipstone Brook
clow-beck	Clow Beck	Clow Beck
coal-burn	Coal Burn	Coal Burn
coastal-stream	Coastal Stream	Coastal Stream
cobbins-brook	Cobbins Brook	Cobbins Brook
cock-beck	Cock Beck	Cock Beck
cocker-beck	Cocker Beck	Cocker Beck
cockers-dyke	Cockers Dyke	Cockers Dyke
cockshaw-burn	Cockshaw Burn	Cockshaw Burn
cod-beck	Cod Beck	Cod Beck
cole-brook	Cole Brook	Cole Brook
colliters-brook	Colliters Brook	Colliters Brook
colne-brook	Colne Brook	Colne Brook
colne-water	Colne Water	Colne Water
combe-haven	Combe Haven	Combe Haven
coney-gut	Coney Gut	Coney Gut
congresbury-yeo	Congresbury Yeo	Congresbury Yeo
costa-beck	Costa Beck	Costa Beck
cove-brook	Cove Brook	Cove Brook
cragg-brook	Cragg Brook	Cragg Brook
cranleigh-waters	Cranleigh Waters	Cranleigh Waters
cripsey-brook	Cripsey Brook	Cripsey Brook
cuckmere-pevensey-levels	Cuckmere & Pevensey Levels	Cuckmere & Pevensey Levels
cundall-beck	Cundall Beck	Cundall Beck
cunsey-beck	Cunsey Beck	Cunsey Beck
currymoor-drain	Currymoor Drain	Currymoor Drain
dacre-beck	Dacre Beck	Dacre Beck
danes-stream	Danes Stream	Danes Stream
daniels-brook	Daniels Brook	Daniels Brook
dauntsey-brook	Dauntsey Brook	Dauntsey Brook
dawlish-water	Dawlish Water	Dawlish Water
day-brook	Day Brook	Day Brook
de-lank-river	De Lank River	De Lank River
dean	Dean	Dean
dean-bottom-beck	Dean Bottom Beck	Dean Bottom Beck
dean-burn	Dean Burn	Dean Burn
deans-brook	Deans Brook	Deans Brook
dimore-brook	Dimore Brook	Dimore Brook
docken-s-water	Docken's Water	Docken's Water
dollis-brook	Dollis Brook	Dollis Brook
doniford-stream	Doniford Stream	Doniford Stream
dorcan-brook	Dorcan Brook	Dorcan Brook
river-frome-dorset	River Frome	River Frome (Dorset)
dover-beck	Dover Beck	Dover Beck
dovers-brook	Dovers Brook	Dovers Brook
dowles-brook	Dowles Brook	Dowles Brook
dragley-beck	Dragley Beck	Dragley Beck
dulas-brook	Dulas Brook	Dulas Brook
ea-beck	Ea Beck	Ea Beck
eagley-brook	Eagley Brook	Eagley Brook
earby-beck	Earby Beck	Earby Beck
east-clandon-stream	East Clandon Stream	East Clandon Stream
east-dart-river	East Dart River	East Dart River
east-fen-catchwater	East Fen Catchwater	East Fen Catchwater
east-glen-river	East Glen River	East Glen River
east-lyn-river	East Lyn River	East Lyn River
east-okement-river	East Okement River	East Okement River
east-stour-kent	East Stour	East Stour (Kent)
east-wilder-brook	East Wilder Brook	East Wilder Brook
eastburn-beck	Eastburn Beck	Eastburn Beck
eastern-yar	Eastern Yar	Eastern Yar
edgware-brook	Edgware Brook	Edgware Brook
egginton-brook	Egginton Brook	Egginton Brook
eller-beck	Eller Beck	Eller Beck
elvington-beck	Elvington Beck	Elvington Beck
emm-brook	Emm Brook	Emm Brook
emral-brook	Emral Brook	Emral Brook
endon-brook	Endon Brook	Endon Brook
eridge-stream	Eridge Stream	Eridge Stream
ewelme-brook	Ewelme Brook	Ewelme Brook
exminster-marshes	Exminster Marshes	Exminster Marshes
farnley-beck	Farnley Beck	Farnley Beck
fenay-beck	Fenay Beck	Fenay Beck
ferring-rife	Ferring Rife	Ferring Rife
field-drain	Field Drain	Field Drain
finham-brook	Finham Brook	Finham Brook
fishlake-stream	Fishlake Stream	Fishlake Stream
fleet-drain	Fleet Drain	Fleet Drain
flood-channel	Flood Channel	Flood Channel
ford-brook	Ford Brook	Ford Brook
ford-green-brook	Ford Green Brook	Ford Green Brook
ford-stream	Ford Stream	Ford Stream
fosdyke-canal	Fosdyke Canal	Fosdyke Canal
foston-beck	Foston Beck	Foston Beck
foston-brook	Foston Brook	Foston Brook
foudry-brook	Foudry Brook	Foudry Brook
fowlea-brook	Fowlea Brook	Fowlea Brook
fowler-bridge-drain	Fowler Bridge Drain	Fowler Bridge Drain
frays-river	Frays River	Frays River
frodingham-beck	Frodingham Beck	Frodingham Beck
gaddesby-brook	Gaddesby Brook	Gaddesby Brook
gatwick-stream	Gatwick Stream	Gatwick Stream
gauze-brook	Gauze Brook	Gauze Brook
gelyn	Gelyn	Gelyn
gilwiskaw-brook	Gilwiskaw Brook	Gilwiskaw Brook
ginge-brook	Ginge Brook	Ginge Brook
glaze-brook	Glaze Brook	Glaze Brook
glen-stream	Glen Stream	Glen Stream
glenridding-beck	Glenridding Beck	Glenridding Beck
glossop-brook	Glossop Brook	Glossop Brook
gowdall-ings	Gowdall Ings	Gowdall Ings
grace-dieu-brook	Grace Dieu Brook	Grace Dieu Brook
great-stour-kent	Great Stour	Great Stour (Kent)
green-dyke	Green Dyke	Green Dyke
grimescar-dike	Grimescar Dike	Grimescar Dike
gurnard-luck	Gurnard Luck	Gurnard Luck
gwyle	Gwyle	Gwyle
gypsey-race	Gypsey Race	Gypsey Race
hagnaby-beck	Hagnaby Beck	Hagnaby Beck
halford-stream	Halford Stream	Halford Stream
halse-water	Halse Water	Halse Water
harpers-brook	Harpers Brook	Harpers Brook
hart-burn	Hart Burn	Hart Burn
hartburn-beck	Hartburn Beck	Hartburn Beck
harwood-beck	Harwood Beck	Harwood Beck
hatherley-brook	Hatherley Brook	Hatherley Brook
haweswater-beck	Haweswater Beck	Haweswater Beck
hawkcombe-stream	Hawkcombe Stream	Hawkcombe Stream
heacham-river	Heacham River	Heacham River
hebble-brook	Hebble Brook	Hebble Brook
hebden-water	Hebden Water	Hebden Water
heighington-beck	Heighington Beck	Heighington Beck
hele-stream	Hele Stream	Hele Stream
hellifield-beck	Hellifield Beck	Hellifield Beck
henmore-brook	Henmore Brook	Henmore Brook
hermitage-stream	Hermitage Stream	Hermitage Stream
higher-brixham-watercourse	Higher Brixham Watercourse	Higher Brixham Watercourse
hillfarrance-brook	Hillfarrance Brook	Hillfarrance Brook
hilton-brook	Hilton Brook	Hilton Brook
hinksey-stream	Hinksey Stream	Hinksey Stream
hodge-beck	Hodge Beck	Hodge Beck
hoe-stream	Hoe Stream	Hoe Stream
hogsmill-river	Hogsmill River	Hogsmill River
hol-beck	Hol Beck	Hol Beck
holderness-drain	Holderness Drain	Holderness Drain
holgate-beck	Holgate Beck	Holgate Beck
holme-brook	Holme Brook	Holme Brook
honddu	Honddu	Honddu
horner-water	Horner Water	Horner Water
horsbere-brook	Horsbere Brook	Horsbere Brook
hovingham-beck	Hovingham Beck	Hovingham Beck
hughenden-stream	Hughenden Stream	Hughenden Stream
huish-level-rhyne	Huish Level Rhyne	Huish Level Rhyne
huntingfield-watercourse	Huntingfield Watercourse	Huntingfield Watercourse
ifield-brook	Ifield Brook	Ifield Brook
illey-brook	Illey Brook	Illey Brook
ings-beck	Ings Beck	Ings Beck
irfon	Irfon	Irfon
ithon	Ithon	Ithon
jubilee-river	Jubilee River	Jubilee River
kelbrook-beck	Kelbrook Beck	Kelbrook Beck
kenwith-stream	Kenwith Stream	Kenwith Stream
kielder-burn	Kielder Burn	Kielder Burn
killhope-burn	Killhope Burn	Killhope Burn
kilton-beck	Kilton Beck	Kilton Beck
kingsbridge-north-watercourse	Kingsbridge North Watercourse	Kingsbridge North Watercourse
kingsclere-brook	Kingsclere Brook	Kingsclere Brook
knoll-beck	Knoll Beck	Knoll Beck
knowle-stream	Knowle Stream	Knowle Stream
kyd-brook	Kyd Brook	Kyd Brook
kyd-brook-east-branch	Kyd Brook (East Branch)	Kyd Brook (East Branch)
kyre-brook	Kyre Brook	Kyre Brook
laceby-beck	Laceby Beck	Laceby Beck
landkey-brook	Landkey Brook	Landkey Brook
lands-beck	Lands Beck	Lands Beck
langford-brook	Langford Brook	Langford Brook
lariggan-river	Lariggan River	Lariggan River
law-brook	Law Brook	Law Brook
ledwyche-brook	Ledwyche Brook	Ledwyche Brook
leigh-brook	Leigh Brook	Leigh Brook
letcombe-brook	Letcombe Brook	Letcombe Brook
levisham-beck	Levisham Beck	Levisham Beck
lilley-brook	Lilley Brook	Lilley Brook
limey-water	Limey Water	Limey Water
little-avon-river	Little Avon River	Little Avon River
little-dart-river	Little Dart River	Little Dart River
little-salt-moor-rhyne	Little Salt Moor Rhyne	Little Salt Moor Rhyne
little-stour	Little Stour	Little Stour
littlemead-brook	Littlemead Brook	Littlemead Brook
litton-cheney-stream	Litton Cheney Stream	Litton Cheney Stream
lledan-brook	Lledan Brook	Lledan Brook
llynfi	Llynfi	Llynfi
lochinvar-beck	Lochinvar Beck	Lochinvar Beck
long-brook	Long brook	Long brook
longload-main-drain	Longload Main Drain	Longload Main Drain
longwood-brook	Longwood Brook	Longwood Brook
low-moor-beck	Low Moor Beck	Low Moor Beck
lukely-brook	Lukely Brook	Lukely Brook
lustrum-beck	Lustrum Beck	Lustrum Beck
lyme-brook	Lyme Brook	Lyme Brook
lymington	Lymington	Lymington
maidenhead-ditch	Maidenhead Ditch	Maidenhead Ditch
manacan-river	Manacan River	Manacan River
mangerton-brook	Mangerton Brook	Mangerton Brook
marchington-brook	Marchington Brook	Marchington Brook
marsh-water	Marsh Water	Marsh Water
marston-meysey-brook	Marston Meysey Brook	Marston Meysey Brook
marton-west-beck	Marton West Beck	Marton West Beck
maud-foster-stonebridge-drain	Maud Foster/Stonebridge Drain	Maud Foster/Stonebridge Drain
meadlake-ditch	Meadlake Ditch	Meadlake Ditch
meanwood-beck	Meanwood Beck	Meanwood Beck
mearley-brook	Mearley Brook	Mearley Brook
medbourne-brook	Medbourne Brook	Medbourne Brook
meece-brook	Meece Brook	Meece Brook
meers-brook	Meers Brook	Meers Brook
mells-river	Mells River	Mells River
merrow-common-stream	Merrow Common Stream	Merrow Common Stream
mevagissey-stream	Mevagissey Stream	Mevagissey Stream
mickley-dyke	Mickley Dyke	Mickley Dyke
midford-brook	Midford Brook	Midford Brook
mill-beck-back-delphin	Mill Beck	Mill Beck (Back Delphin)
mill-beck-derwent	Mill Beck	Mill Beck (Derwent)
mill-bourne	Mill Bourne	Mill Bourne
mill-brook-devon	Mill Brook	Mill Brook (Devon)
mill-brook-herefordshire	Mill Brook	Mill Brook (Herefordshire)
mill-brook-oxfordshire	Mill Brook	Mill Brook (Oxfordshire)
mimmshall-brook	Mimmshall Brook	Mimmshall Brook
mires-beck	Mires Beck	Mires Beck
monk-dyke	Monk Dyke	Monk Dyke
monks-brook	Monks Brook	Monks Brook
monksilver-stream	Monksilver Stream	Monksilver Stream
monktonmead-brook	Monktonmead Brook	Monktonmead Brook
monnow	Monnow	Monnow
moors-burn	Moors Burn	Moors Burn
moors-river	Moors River	Moors River
mutton-brook	Mutton Brook	Mutton Brook
nailbourne	Nailbourne	Nailbourne
nazeing-brook	Nazeing Brook	Nazeing Brook
netherley-brook	Netherley Brook	Netherley Brook
nettleham-beck	Nettleham Beck	Nettleham Beck
new-cut	New Cut	New Cut
norbury-brook	Norbury Brook	Norbury Brook
north-drain	North Drain	North Drain
northmoor-main-drain	Northmoor Main Drain	Northmoor Main Drain
nunney-brook	Nunney Brook	Nunney Brook
oakenshaw-beck	Oakenshaw Beck	Oakenshaw Beck
oakington-brook	Oakington Brook	Oakington Brook
oakley-cross-beck	Oakley Cross Beck	Oakley Cross Beck
ogden-brook	Ogden Brook	Ogden Brook
oil-mill-beck	Oil Mill Beck	Oil Mill Beck
old-bedford-river	Old Bedford River	Old Bedford River
old-mill-stream	Old Mill Stream	Old Mill Stream
oldbury-naite-rhyne	Oldbury Naite Rhyne	Oldbury Naite Rhyne
ormesby-beck	Ormesby Beck	Ormesby Beck
otterton-brook	Otterton Brook	Otterton Brook
oulton-beck	Oulton Beck	Oulton Beck
ouse-burn	Ouse Burn	Ouse Burn
ouse-dyke	Ouse Dyke	Ouse Dyke
ousemere-lode	Ousemere Lode	Ousemere Lode
oxlease-drain	Oxlease Drain	Oxlease Drain
par-river	Par River	Par River
parham-beck	Parham Beck	Parham Beck
pearl-brook	Pearl Brook	Pearl Brook
penberth-stream	Penberth Stream	Penberth Stream
pendle-water	Pendle Water	Pendle Water
pent-stream	Pent Stream	Pent Stream
perrancombe-stream	Perrancombe Stream	Perrancombe Stream
petersfield-stream	Petersfield Stream	Petersfield Stream
petty-s-brook	Petty's Brook	Petty's Brook
pickering-beck	Pickering Beck	Pickering Beck
picknall-brook	Picknall Brook	Picknall Brook
piddle-brook	Piddle Brook	Piddle Brook
pillhill-brook	Pillhill Brook	Pillhill Brook
pimlico-brook	Pimlico Brook	Pimlico Brook
pincey-brook	Pincey Brook	Pincey Brook
pishiobury-brook	Pishiobury Brook	Pishiobury Brook
pocklington-beck	Pocklington Beck	Pocklington Beck
pointon-lode	Pointon Lode	Pointon Lode
porter-brook	Porter Brook	Porter Brook
poyle-channel	Poyle Channel	Poyle Channel
poynton-brook	Poynton Brook	Poynton Brook
praze-stream	Praze Stream	Praze Stream
priorpot-beck	Priorpot Beck	Priorpot Beck
pyl-brook	Pyl Brook	Pyl Brook
pymmes-brook	Pymmes Brook	Pymmes Brook
quy-water	Quy Water	Quy Water
radlett-brook	Radlett Brook	Radlett Brook
rags-brook	Rags Brook	Rags Brook
rattlesden-river	Rattlesden River	Rattlesden River
rea-brook	Rea Brook	Rea Brook
red-cornwall	Red	Red (Cornwall)
red-hertfordshire	Red	Red (Hertfordshire)
redhill-brook	Redhill Brook	Redhill Brook
ridings-brook	Ridings Brook	Ridings Brook
rising-brook	Rising Brook	Rising Brook
river-adur	River Adur	River Adur
river-aire	River Aire	River Aire
river-alde	River Alde	River Alde
river-allen-cornwall-north	River Allen	River Allen (Cornwall North)
river-allen-cornwall-south	River Allen	River Allen (Cornwall South)
river-allen-dorset	River Allen	River Allen (Dorset)
river-aller	River Aller	River Aller
river-alne	River Alne	River Alne
river-alre	River Alre	River Alre
river-alt	River Alt	River Alt
river-alver	River Alver	River Alver
river-amber	River Amber	River Amber
river-ancholme	River Ancholme	River Ancholme
river-anker	River Anker	River Anker
river-ant	River Ant	River Ant
river-anton	River Anton	River Anton
river-arrow-herefordshire	River Arrow	River Arrow (Herefordshire)
river-arrow-warwickshire	River Arrow	River Arrow (Warwickshire)
river-arun	River Arun	River Arun
river-ash-hertfordshire	River Ash	River Ash (Hertfordshire)
river-ash-middlesex	River Ash	River Ash (Middlesex)
river-ashburn	River Ashburn	River Ashburn
river-asker	River Asker	River Asker
river-avon-bristol	River Avon	River Avon (Bristol)
river-avon-corsham	River Avon	River Avon (Corsham)
river-avon-devon	River Avon	River Avon (Devon)
river-avon-hampshire	River Avon	River Avon (Hampshire)
river-avon-warwickshire	River Avon	River Avon (Warwickshire)
river-axe-devon	River Axe	River Axe (Devon)
river-axe-somerset	River Axe	River Axe (Somerset)
river-bain	River Bain	River Bain
river-banwy	River Banwy	River Banwy
river-barle	River Barle	River Barle
river-batherm	River Batherm	River Batherm
river-beal	River Beal	River Beal
river-beam	River Beam	River Beam
river-beane	River Beane	River Beane
river-beult	River Beult	River Beult
river-bela	River Bela	River Bela
river-birket	River Birket	River Birket
river-biss	River Biss	River Biss
river-blackwater-essex	River Blackwater	River Blackwater (Essex)
river-blackwater-loddon	River Blackwater	River Blackwater (Loddon)
river-blackwater-new-forest	River Blackwate	River Blackwater (New Forest)
river-blakewater	River Blakewater	River Blakewater
river-blithe	River Blithe	River Blithe
river-blyth	River Blyth	River Blyth
river-blythe	River Blythe	River Blythe
river-bollin	River Bollin	River Bollin
river-bourne-addlestone	River Bourne	River Bourne (Addlestone)
river-bourne-chertsey	River Bourne	River Bourne (Chertsey)
river-bourne-kent	River Bourne	River Bourne (Kent)
river-bourne-wiltshire	River Bourne	River Bourne (Wiltshire)
river-bovey	River Bovey	River Bovey
river-bovey-wifford-tributary	River Bovey Wifford Tributary	River Bovey Wifford Tributary
river-box	River Box	River Box
river-boyd	River Boyd	River Boyd
river-brain	River Brain	River Brain
river-brant	River Brant	River Brant
river-brathay	River Brathay	River Brathay
river-bray	River Bray	River Bray
river-brede	River Brede	River Brede
river-brent	River Brent	River Brent
river-brett	River Brett	River Brett
river-bride	River Bride	River Bride
river-brit	River Brit	River Brit
river-brock	River Brock	River Brock
river-browney	River Browney	River Browney
river-brue	River Brue	River Brue
river-brun	River Brun	River Brun
river-bulbourne	River Bulbourne	River Bulbourne
river-bull	River Bull	River Bull
river-bure	River Bure	River Bure
river-burn	River Burn	River Burn
river-dudwell	River Dudwell	River Dudwell
river-caen	River Caen	River Caen
river-cain	River Cain	River Cain
river-calder-cumbria	River Calder	River Calder (Cumbria)
river-calder-lancashire	River Calder	River Calder (Lancashire)
river-calder-yorkshire	River Calder	River Calder (Yorkshire)
river-caldew	River Caldew	River Caldew
river-cale	River Cale	River Cale
river-cam-cambridgeshire	River Cam	River Cam (Cambridgeshire)
river-cam-severn	River Cam	River Cam (Severn)
river-cam-somerset	River Cam	River Cam (Somerset)
river-camel	River Camel	River Camel
river-can	River Can	River Can
river-char	River Char	River Char
river-chater	River Chater	River Chater
river-chelmer	River Chelmer	River Chelmer
river-chelt	River Chelt	River Chelt
river-cherwell	River Cherwell	River Cherwell
river-chess	River Chess	River Chess
river-chew	River Chew	River Chew
river-churn	River Churn	River Churn
river-churnet	River Churnet	River Churnet
river-clyst	River Clyst	River Clyst
river-clyst-clyst-st-mary-tributary	River Clyst, Clyst St Mary Tributary	River Clyst, Clyst St Mary Tributary
river-clywedog	River Clywedog	River Clywedog
river-cober	River Cober	River Cober
river-cocker	River Cocker	River Cocker
river-cole-staffordshire	River Cole	River Cole (Staffordshire)
river-cole-wiltshire	River Cole	River Cole (Wiltshire)
river-coln	River Coln	River Coln
river-colne-essex	River Colne	River Colne (Essex)
river-colne-hertfordshire	River Colne	River Colne (Hertfordshire)
river-colne-yorkshire	River Colne	River Colne (Yorkshire)
river-coly	River Coly	River Coly
river-conder	River Conder	River Conder
river-coquet	River Coquet	River Coquet
river-corve	River Corve	River Corve
river-crake	River Crake	River Crake
river-crane	River Crane	River Crane
river-cray	River Cray	River Cray
river-creedy	River Creedy	River Creedy
river-crimple	River Crimple	River Crimple
river-croal	River Croal	River Croal
river-crouch	River Crouch	River Crouch
river-cuckmere	River Cuckmere	River Cuckmere
river-culm	River Culm	River Culm
river-dane	River Dane	River Dane
river-darent	River Darent	River Darent
river-dart	River Dart	River Dart
river-darwen	River Darwen	River Darwen
river-dearne	River Dearne	River Dearne
river-deben	River Deben	River Deben
river-dee	River Dee	River Dee
river-dene-gloucestershire	River Dene	River Dene (Gloucestershire)
river-dene-warwickshire	River Dene	River Dene (Warwickshire)
river-derwent-cumbria	River Derwent	River Derwent (Cumbria)
river-derwent-derbyshire	River Derwent	River Derwent (Derbyshire)
river-derwent-northumberland	River Derwent	River Derwent (Northumberland)
river-derwent-yorkshire	River Derwent	River Derwent (Yorkshire)
river-dever	River Dever	River Dever
river-devon	River Devon	River Devon
river-dikler	River Dikler	River Dikler
river-doe-lea	River Doe Lea	River Doe Lea
river-don	River Don	River Don
river-dore	River Dore	River Dore
river-douglas	River Douglas	River Douglas
river-dour	River Dour	River Dour
river-dove-north-yorkshire	River Dove	River Dove (North Yorkshire)
river-dove-south-yorkshire	River Dove	River Dove (South Yorkshire)
river-dove-staffordshire	River Dove	River Dove (Staffordshire)
river-drone	River Drone	River Drone
river-duddon	River Duddon	River Duddon
river-darwell	River Darwell	River Darwell
river-dulas	River Dulas	River Dulas
river-dun-berkshire	River Dun	River Dun (Berkshire)
river-dun-hampshire	River Dun	River Dun (Hampshire)
river-eamont	River Eamont	River Eamont
river-east-allen	River East Allen	River East Allen
river-eau	River Eau	River Eau
river-ebble	River Ebble	River Ebble
river-ecclesbourne	River Ecclesbourne	River Ecclesbourne
river-eden-cumbria	River Eden	River Eden (Cumbria)
river-eden-kent	River Eden	River Eden (Kent)
river-ehen	River Ehen	River Ehen
river-elan	River Elan	River Elan
river-ellen	River Ellen	River Ellen
river-ems	River Ems	River Ems
river-enborne	River Enborne	River Enborne
river-erewash	River Erewash	River Erewash
river-erme	River Erme	River Erme
river-esk-north-cumbria	River Esk	River Esk (North Cumbria)
river-esk-west-cumbria	River Esk	River Esk (West Cumbria)
river-esk-yorkshire	River Esk	River Esk (Yorkshire)
river-etherow	River Etherow	River Etherow
river-evenlode	River Evenlode	River Evenlode
river-exe	River Exe	River Exe
river-fal	River Fal	River Fal
river-flit	River Flit	River Flit
river-font	River Font	River Font
river-foss	River Foss	River Foss
river-foulness	River Foulness	River Foulness
river-fowey	River Fowey	River Fowey
river-frome-bristol	River Frome	River Frome (Bristol)
river-frome-severn	River Frome	River Frome (Severn)
river-frome-wye	River Frome	River Frome (Wye)
river-fromus	River Fromus	River Fromus
river-gade	River Gade	River Gade
river-gannel	River Gannel	River Gannel
river-gaunless	River Gaunless	River Gaunless
river-gelt	River Gelt	River Gelt
river-gipping	River Gipping	River Gipping
river-glem	River Glem	River Glem
river-glen	River Glen	River Glen
river-glenderamackin	River Glenderamackin	River Glenderamackin
river-glyme	River Glyme	River Glyme
river-gowan	River Gowan	River Gowan
river-gowy	River Gowy	River Gowy
river-goyt	River Goyt	River Goyt
river-granta	River Granta	River Granta
river-graveney	River Graveney	River Graveney
river-great-ouse	River Great Ouse	River Great Ouse
river-greet	River Greet	River Greet
river-greta-cumbria	River Greta	River Greta (Cumbria)
river-greta-durham	River Greta	River Greta (Durham)
river-haddeo	River Haddeo	River Haddeo
river-hamble	River Hamble	River Hamble
river-hamps	River Hamps	River Hamps
river-harbourne	River Harbourne	River Harbourne
river-harbourne-harbertonford-tributary	River Harbourne, Harbertonford Tributary	River Harbourne, Harbertonford Tributary
river-hart	River Hart	River Hart
river-hayle	River Hayle	River Hayle
river-hindburn	River Hindburn	River Hindburn
river-hipper	River Hipper	River Hipper
river-hiz	River Hiz	River Hiz
river-hodder	River Hodder	River Hodder
river-holme	River Holme	River Holme
river-hooke	River Hooke	River Hooke
river-hull	River Hull	River Hull
river-hyndburn	River Hyndburn	River Hyndburn
river-idle	River Idle	River Idle
river-ingrebourne	River Ingrebourne	River Ingrebourne
river-inny	River Inny	River Inny
river-irk	River Irk	River Irk
river-irt	River Irt	River Irt
river-irthing	River Irthing	River Irthing
river-irwell	River Irwell	River Irwell
river-isbourne	River Isbourne	River Isbourne
river-ise	River Ise	River Ise
river-isle	River Isle	River Isle
river-itchen-hampshire	River Itchen	River Itchen (Hampshire)
river-itchen-warwickshire	River Itchen	River Itchen (Warwickshire)
river-ivel	River Ivel	River Ivel
river-jordan	River Jordan	River Jordan
river-keekle	River Keekle	River Keekle
river-keer	River Keer	River Keer
river-kenn-tributary	River Kenn Tributary	River Kenn Tributary
river-kennall	River Kennall	River Kennall
river-kennet	River Kennet	River Kennet
river-kennett	River Kennett	River Kennett
river-kensey	River Kensey	River Kensey
river-kent	River Kent	River Kent
river-kenwyn	River Kenwyn	River Kenwyn
river-key	River Key	River Key
river-kyle	River Kyle	River Kyle
river-kym	River Kym	River Kym
river-lambourn	River Lambourn	River Lambourn
river-lark	River Lark	River Lark
river-lavant-hampshire	River Lavant	River Lavant (Hampshire)
river-lavant-sussex	River Lavant	River Lavant (Sussex)
river-laver	River Laver	River Laver
river-lee	River Lee	River Lee
river-leach	River Leach	River Leach
river-leadon	River Leadon	River Leadon
river-leam	River Leam	River Leam
river-leen	River Leen	River Leen
river-lemon	River Lemon	River Lemon
river-leven-cumbria	River Leven	River Leven (Cumbria)
river-leven-yorkshire	River Leven	River Leven (Yorkshire)
river-lew	River Lew	River Lew
river-lim	River Lim	River Lim
river-lin	River Lin	River Lin
river-little-ouse	River Little Ouse	River Little Ouse
river-lod	River Lod	River Lod
river-loddon	River Loddon	River Loddon
river-lostock	River Lostock	River Lostock
river-lowman	River Lowman	River Lowman
river-lowther	River Lowther	River Lowther
river-lox	River Lox	River Lox
river-loxley	River Loxley	River Loxley
river-lud	River Lud	River Lud
river-lugg	River Lugg	River Lugg
river-lune	River Lune	River Lune
river-lyd-devon	River Lyd	River Lyd (Devon)
river-lyd-gloucestershire	River Lyd	River Lyd (Gloucestershire)
river-lydden	River Lydden	River Lydden
river-lymn	River Lymn	River Lymn
river-lynher	River Lynher	River Lynher
river-manifold	River Manifold	River Manifold
river-marden	River Marden	River Marden
river-mardle	River Mardle	River Mardle
river-maun	River Maun	River Maun
river-mease	River Mease	River Mease
river-meden	River Meden	River Meden
river-medina	River Medina	River Medina
river-medlock	River Medlock	River Medlock
river-medway	River Medway	River Medway
river-meese	River Meese	River Meese
river-meon	River Meon	River Meon
river-mersey	River Mersey	River Mersey
river-mimram	River Mimram	River Mimram
river-mint	River Mint	River Mint
river-misbourne	River Misbourne	River Misbourne
river-mole-devon	River Mole	River Mole (Devon)
river-mole-surrey	River Mole	River Mole (Surrey)
river-nadder	River Nadder	River Nadder
river-nar	River Nar	River Nar
river-neet	River Neet	River Neet
river-nene	River Nene	River Nene
river-nidd	River Nidd	River Nidd
river-north-lew	River North Lew	River North Lew
river-north-tyne	River North Tyne	River North Tyne
river-ock	River Ock	River Ock
river-og	River Og	River Og
river-okement	River Okement	River Okement
river-onny	River Onny	River Onny
river-ore	River Ore	River Ore
river-otter	River Otter	River Otter
river-ottery	River Ottery	River Ottery
river-ouse-sussex	River Ouse	River Ouse (Sussex)
river-ouse-yorkshire	River Ouse	River Ouse (Yorkshire)
river-ouzel	River Ouzel	River Ouzel
river-pang	River Pang	River Pang
river-pant	River Pant	River Pant
river-parrett	River Parrett	River Parrett
river-penk	River Penk	River Penk
river-perry	River Perry	River Perry
river-petteril	River Petteril	River Petteril
river-piddle	River Piddle	River Piddle
river-pinn	River Pinn	River Pinn
river-plym	River Plym	River Plym
river-pol	River Pol	River Pol
river-pont	River Pont	River Pont
river-pool	River Pool	River Pool
river-poulter	River Poulter	River Poulter
river-quaggy	River Quaggy	River Quaggy
river-quin	River Quin	River Quin
river-rase	River Rase	River Rase
river-ravensbourne	River Ravensbourne	River Ravensbourne
river-ravensbourne-east-branch	River Ravensbourne (East branch)	River Ravensbourne (East branch)
river-rawthey	River Rawthey	River Rawthey
river-ray	River Ray	River Ray
river-rea-shropshire	River Rea	River Rea (Shropshire)
river-rea-west-midlands	River Rea	River Rea (West Midlands)
river-rede	River Rede	River Rede
river-rhee	River Rhee	River Rhee
river-rib	River Rib	River Rib
river-ribble	River Ribble	River Ribble
river-riccal	River Riccal	River Riccal
river-roch	River Roch	River Roch
river-roden	River Roden	River Roden
river-roding	River Roding	River Roding
river-rom	River Rom	River Rom
river-rothay	River Rothay	River Rothay
river-rother-kent	River Rother	River Rother (Kent)
river-rother-sussex	River Rother	River Rother (Sussex)
river-rother-yorkshire	River Rother	River Rother (Yorkshire)
river-ryburn	River Ryburn	River Ryburn
river-rye	River Rye	River Rye
river-ryton	River Ryton	River Ryton
river-salwarpe	River Salwarpe	River Salwarpe
river-seaton	River Seaton	River Seaton
river-sence-leicestershire	River Sence	River Sence (Leicestershire)
river-sence-west-leicestershire	River Sence	River Sence (West Leicestershire)
river-seven	River Seven	River Seven
river-severn	River Severn	River Severn
river-shalbourne	River Shalbourne	River Shalbourne
river-sheaf	River Sheaf	River Sheaf
river-sheppey	River Sheppey	River Sheppey
river-sherbourne	River Sherbourne	River Sherbourne
river-shuttle	River Shuttle	River Shuttle
river-sid	River Sid	River Sid
river-skell	River Skell	River Skell
river-skerne	River Skerne	River Skerne
river-slea	River Slea	River Slea
river-smite	River Smite	River Smite
river-snail	River Snail	River Snail
river-soar	River Soar	River Soar
river-south-tyne	River South Tyne	River South Tyne
river-sow	River Sow	River Sow
river-sowe	River Sowe	River Sowe
river-sowy	River Sowy	River Sowy
river-sprint	River Sprint	River Sprint
river-steeping	River Steeping	River Steeping
river-stennack	River Stennack	River Stennack
river-stert	River Stert	River Stert
river-stiffkey	River Stiffkey	River Stiffkey
river-stort	River Stort	River Stort
river-stour-dorset	River Stour	River Stour (Dorset)
river-stour-essex	River Stour	River Stour (Essex)
river-stour-warwickshire	River Stour	River Stour (Warwickshire)
river-stour-worcestershire	River Stour	River Stour (Worcestershire)
river-strat	River Strat	River Strat
river-strine	River Strine	River Strine
river-swale	River Swale	River Swale
river-swarbourne	River Swarbourne	River Swarbourne
river-swift-hampshire	River Swift	River Swift (Hampshire)
river-swift-warwickshire	River Swift	River Swift (Warwickshire)
river-tale	River Tale	River Tale
river-tamar	River Tamar	River Tamar
river-tame-greater-manchester	River Tame	River Tame (Greater Manchester)
river-tame-west-midlands	River Tame	River Tame (West Midlands)
river-tanat	River Tanat	River Tanat
river-tavy	River Tavy	River Tavy
river-taw	River Taw	River Taw
river-team	River Team	River Team
river-tean	River Tean	River Tean
river-tees	River Tees	River Tees
river-teign	River Teign	River Teign
river-teise	River Teise	River Teise
river-teme	River Teme	River Teme
river-tern	River Tern	River Tern
river-test	River Test	River Test
river-thame	River Thame	River Thame
river-thames	River Thames	River Thames
river-thet	River Thet	River Thet
river-thrushel	River Thrushel	River Thrushel
river-thurne	River Thurne	River Thurne
river-tiddy	River Tiddy	River Tiddy
river-till-lincolnshire	River Till	River Till (Lincolnshire)
river-till-northumberland	River Till	River Till (Northumberland)
river-tillingbourne	River Tillingbourne	River Tillingbourne
river-tillingham	River Tillingham	River Tillingham
river-tone	River Tone	River Tone
river-torridge	River Torridge	River Torridge
river-tove	River Tove	River Tove
river-trent	River Trent	River Trent
river-tud	River Tud	River Tud
river-tutt	River Tutt	River Tutt
river-tweed	River Tweed	River Tweed
river-twyver	River Twyver	River Twyver
river-tyne	River Tyne	River Tyne
river-uck	River Uck	River Uck
river-umber	River Umber	River Umber
river-ure	River Ure	River Ure
river-valency	River Valency	River Valency
river-ver	River Ver	River Ver
river-vyrnwy	River Vyrnwy	River Vyrnwy
river-waldon	River Waldon	River Waldon
river-walkham	River Walkham	River Walkham
river-wallington-cambridgeshire	River Wallington	River Wallington (Cambridgeshire)
river-wallington-hampshire	River Wallington	River Wallington (Hampshire)
river-wandle	River Wandle	River Wandle
river-wansbeck	River Wansbeck	River Wansbeck
river-waring	River Waring	River Waring
river-waveney	River Waveney	River Waveney
river-wear	River Wear	River Wear
river-weaver	River Weaver	River Weaver
river-welland	River Welland	River Welland
river-wenning	River Wenning	River Wenning
river-wensum	River Wensum	River Wensum
river-went	River Went	River Went
river-west-allen	River West Allen	River West Allen
river-wey-dorset	River Wey	River Wey (Dorset)
river-wey-surrey	River Wey	River Wey (Surrey)
river-wharfe	River Wharfe	River Wharfe
river-whitewater	River Whitewater	River Whitewater
river-whitting	River Whitting	River Whitting
river-whittle	River Whittle	River Whittle
river-wid	River Wid	River Wid
river-windrush	River Windrush	River Windrush
river-winterbourne	River Winterbourne	River Winterbourne
river-wiske	River Wiske	River Wiske
river-wissey	River Wissey	River Wissey
river-witham	River Witham	River Witham
river-wolf	River Wolf	River Wolf
river-worfe	River Worfe	River Worfe
river-worth	River Worth	River Worth
river-wreake	River Wreake	River Wreake
river-wriggle	River Wriggle	River Wriggle
river-wye	River Wye	River Wye
river-wye-buckinghamshire	River Wye	River Wye (Buckinghamshire)
river-wye-derbyshire	River Wye	River Wye (Derbyshire)
river-wylye	River Wylye	River Wylye
river-wyre	River Wyre	River Wyre
river-yare	River Yare	River Yare
river-yarrow	River Yarrow	River Yarrow
river-yarty	River Yarty	River Yarty
river-yealm	River Yealm	River Yealm
river-yeo-creedy	River Yeo	River Yeo (Creedy)
river-yeo-lapford	River Yeo	River Yeo (Lapford)
river-yeo-somerset	River Yeo	River Yeo (Somerset)
roall-dyke	Roall Dyke	Roall Dyke
roe-beck	Roe Beck	Roe Beck
rolleston-brook	Rolleston Brook	Rolleston Brook
rookhope-burn	Rookhope Burn	Rookhope Burn
rothley-brook	Rothley Brook	Rothley Brook
rudhall-brook	Rudhall Brook	Rudhall Brook
ruskington-beck	Ruskington Beck	Ruskington Beck
rye-meads-effluent-channel	Rye Meads Effluent Channel	Rye Meads Effluent Channel
sabden-brook	Sabden Brook	Sabden Brook
salfords-stream-kent	Salfords Stream	Salfords Stream (Kent)
salfords-stream-sussex	Salfords Stream	Salfords Stream (Sussex)
salmon-brook	Salmon Brook	Salmon Brook
salt-haven	Salt Haven	Salt Haven
sampford-brett-stream	Sampford Brett Stream	Sampford Brett Stream
sandon-brook	Sandon Brook	Sandon Brook
sandy-brook	Sandy Brook	Sandy Brook
sandyford-brook	Sandyford Brook	Sandyford Brook
sankey-brook	Sankey Brook	Sankey Brook
saredon-brook	Saredon Brook	Saredon Brook
scurf-dyke	Scurf Dyke	Scurf Dyke
sea-cut	Sea Cut	Sea Cut
seacourt-stream	Seacourt Stream	Seacourt Stream
selby-dam	Selby Dam	Selby Dam
semington-brook	Semington Brook	Semington Brook
setting-dyke	Setting Dyke	Setting Dyke
shaw-brook-tributary	Shaw Brook Tributary	Shaw Brook Tributary
sherston-avon	Sherston Avon	Sherston Avon
shill-brook	Shill Brook	Shill Brook
shreen-water	Shreen Water	Shreen Water
shutterton-brook	Shutterton Brook	Shutterton Brook
silk-stream	Silk Stream	Silk Stream
silsden-beck	Silsden Beck	Silsden Beck
sincil-dyke	Sincil Dyke	Sincil Dyke
sinderland-brook	Sinderland Brook	Sinderland Brook
skeffling-drain	Skeffling Drain	Skeffling Drain
skirting-beck	Skirting Beck	Skirting Beck
slad-brook	Slad Brook	Slad Brook
smallhope-burn	Smallhope Burn	Smallhope Burn
smestow-brook	Smestow Brook	Smestow Brook
snaith-ings	Snaith Ings	Snaith Ings
snaizeholme-beck	Snaizeholme Beck	Snaizeholme Beck
somborne-stream	Somborne Stream	Somborne Stream
river-frome-somerset	River Frome	River Frome (Somerset)
sor-brook	Sor Brook	Sor Brook
sour-beck	Sour Beck	Sour Beck
south-brook	South Brook	South Brook
south-cave-beck	South Cave Beck	South Cave Beck
south-forty-foot-drain	South Forty Foot Drain	South Forty Foot Drain
southcourt-brook	Southcourt Brook	Southcourt Brook
spen-beck	Spen Beck	Spen Beck
spratford-stream	Spratford Stream	Spratford Stream
spring-brook	Spring Brook	Spring Brook
st-austell-river	St Austell River	St Austell River
st-blazey-stream	St Blazey Stream	St Blazey Stream
st-james-stream	St James Stream	St James Stream
st-johns-beck	St Johns Beck	St Johns Beck
st-neot-river	St Neot River	St Neot River
stainfield-beck	Stainfield Beck	Stainfield Beck
stansted-brook	Stansted Brook	Stansted Brook
stevenage-brook	Stevenage Brook	Stevenage Brook
stock-beck	Stock Beck	Stock Beck
stock-ghyll	Stock Ghyll	Stock Ghyll
stonham-watercourse	Stonham Watercourse	Stonham Watercourse
stour-brook	Stour Brook	Stour Brook
sud-brook	Sud Brook	Sud Brook
sulham-brook	Sulham Brook	Sulham Brook
sutton-beck	Sutton Beck	Sutton Beck
swalecliffe-brook	Swalecliffe Brook	Swalecliffe Brook
swan-brook	Swan Brook	Swan Brook
swavesey-drain	Swavesey Drain	Swavesey Drain
swill-brook	Swill Brook	Swill Brook
swinney-beck	Swinney Beck	Swinney Beck
syd-brook	Syd Brook	Syd Brook
sydling-water	Sydling Water	Sydling Water
tadburn-lake	Tadburn Lake	Tadburn Lake
tang-hall-beck	Tang Hall Beck	Tang Hall Beck
tanners-brook	Tanners Brook	Tanners Brook
tetbury-avon	Tetbury Avon	Tetbury Avon
thacka-beck	Thacka Beck	Thacka Beck
the-beck	The Beck	The Beck
the-cut	The Cut	The Cut
the-fleet	The Fleet	The Fleet
the-gissage	The Gissage	The Gissage
the-moss	The Moss	The Moss
the-porter-river	The Porter River	The Porter River
the-roxbourne	The Roxbourne	The Roxbourne
theobalds-brook	Theobalds Brook	Theobalds Brook
thorngumbald-drain	Thorngumbald Drain	Thorngumbald Drain
thornton-beck	Thornton Beck	Thornton Beck
tory-brook	Tory Brook	Tory Brook
town-beck	Town Beck	Town Beck
trawden-brook	Trawden Brook	Trawden Brook
tresillian-river	Tresillian River	Tresillian River
trothy	Trothy	Trothy
trout-beck-east-cumbria	Trout Beck	Trout Beck (East Cumbria)
trout-beck-lake-district	Trout Beck	Trout Beck (Lake District)
trout-beck-northumberland	Trout Beck	Trout Beck (Northumberland)
tryweryn	Tryweryn	Tryweryn
turkey-brook	Turkey Brook	Turkey Brook
twin	Twin	Twin
ulley-brook	Ulley Brook	Ulley Brook
ullswater	Ullswater	Ullswater
umborne-brook	Umborne Brook	Umborne Brook
usway-burn	Usway Burn	Usway Burn
valley-brook	Valley Brook	Valley Brook
waithe-beck	Waithe Beck	Waithe Beck
walkford-brook	Walkford Brook	Walkford Brook
waller-hill-beck	Waller Hill Beck	Waller Hill Beck
wallop-brook	Wallop Brook	Wallop Brook
walsden-water	Walsden Water	Walsden Water
waren-burn	Waren Burn	Waren Burn
warleggan-river	Warleggan River	Warleggan River
wash-dike	Wash Dike	Wash Dike
washford-river	Washford River	Washford River
washpit-brook	Washpit Brook	Washpit Brook
wealdstone-brook	Wealdstone Brook	Wealdstone Brook
weedon-beck	Weedon Beck	Weedon Beck
wellow-brook	Wellow Brook	Wellow Brook
wendlebury-brook	Wendlebury Brook	Wendlebury Brook
wendling-beck	Wendling Beck	Wendling Beck
wendover-springs	Wendover Springs	Wendover Springs
wesley-brook	Wesley Brook	Wesley Brook
west-bank-pond	West Bank Pond	West Bank Pond
west-beck-county-durham	West Beck	West Beck (County Durham)
west-brook-hampshire	West Brook	West Brook (Hampshire)
west-brook-kent	West Brook	West Brook (Kent)
west-clough	West Clough	West Clough
west-dart-river	West Dart River	West Dart River
west-fen-catchwater-drain	West Fen Catchwater Drain	West Fen Catchwater Drain
west-glen-river	West Glen River	West Glen River
west-lyn-river	West Lyn River	West Lyn River
west-moor-drain	West Moor Drain	West Moor Drain
west-okement-river	West Okement River	West Okement River
west-sedgemoor-drain	West Sedgemoor Drain	West Sedgemoor Drain
western-drain	Western Drain	Western Drain
western-yar	Western Yar	Western Yar
whaddon-brook-cambridgeshire	Whaddon Brook	Whaddon Brook (Cambridgeshire)
whaddon-brook-gloucestershire	Whaddon Brook	Whaddon Brook (Gloucestershire)
wheelan-dyke	Wheelan Dyke	Wheelan Dyke
whetstone-brook	Whetstone Brook	Whetstone Brook
whiston-brook	Whiston Brook	Whiston Brook
white-water-dyke	White Water Dyke	White Water Dyke
whitley-beck	Whitley Beck	Whitley Beck
whitley-brook	Whitley Brook	Whitley Brook
willow-beck	Willow Beck	Willow Beck
willow-brook	Willow Brook	Willow Brook
wincham-brook	Wincham Brook	Wincham Brook
windermere	Windermere	Windermere
windle-brook	Windle Brook	Windle Brook
winestead-drain	Winestead Drain	Winestead Drain
winford-brook	Winford Brook	Winford Brook
winterbourne-stream-berkshire	Winterbourne Stream	Winterbourne Stream (Berkshire)
winterbourne-stream-sussex	Winterbourne Stream	Winterbourne Stream (Sussex)
witcombe-bottom-main-drain	Witcombe Bottom Main Drain	Witcombe Bottom Main Drain
withy-brook	Withy Brook	Withy Brook
withycombe-brook	Withycombe Brook	Withycombe Brook
wiza-beck	Wiza Beck	Wiza Beck
wood-brook	Wood Brook	Wood Brook
woodbridge-brook	Woodbridge Brook	Woodbridge Brook
wool-brook	Wool Brook	Wool Brook
wooler-water	Wooler Water	Wooler Water
wootton-brook	Wootton Brook	Wootton Brook
worsley-brook	Worsley Brook	Worsley Brook
wortley-beck	Wortley Beck	Wortley Beck
wotton-brook-devon	Wotton Brook	Wotton Brook (Devon)
wotton-brook-gloucestershire	Wotton Brook	Wotton Brook (Gloucestershire)
wraysbury-river	Wraysbury River	Wraysbury River
wych-brook	Wych Brook	Wych Brook
wydon-burn	Wydon Burn	Wydon Burn
wyke-beck	Wyke Beck	Wyke Beck
wymans-brook	Wymans Brook	Wymans Brook
yazor-brook	Yazor Brook	Yazor Brook
yeading-brook	Yeading Brook	Yeading Brook
yeading-brook-eastern-arm	Yeading Brook	Yeading Brook (Eastern Arm)
yeolands-stream	Yeolands Stream	Yeolands Stream
river-lodden-dorset	River Lodden	River Lodden (Dorset)
beauvale-brook	Beauvale Brook	Beauvale Brook
beverley-and-barmston-drain	Beverley and Barmston Drain	Beverley and Barmston Drain
blind-beck	Blind Beck	Blind Beck
borsdane-brook	Borsdane Brook	Borsdane Brook
borehamwood-brook	Borehamwood Brook	Borehamwood Brook
borough-beck	Borough Beck	Borough Beck
boyces-brook	Boyces Brook	Boyces Brook
bradwell-brook	Bradwell Brook	Bradwell Brook
broadlane-beck	Broadlane Beck	Broadlane Beck
brough-clough	Brough Clough	Brough Clough
coniston-water	Coniston Water	Coniston Water
counter-drain	Counter Drain	Counter Drain
cowbridge-beck	Cowbridge Beck	Cowbridge Beck
crook-beck	Crook Beck	Crook Beck
eea-river	Eea River	Eea River
ewood-mill-race	Ewood Mill Race	Ewood Mill Race
gill-beck	Gill Beck	Gill Beck
haweswater-reservoir	Haweswater Reservoir	Haweswater Reservoir
heys-brook	Heys Brook	Heys Brook
horsebridge-dyke	Horsebridge Dyke	Horsebridge Dyke
keyingham-drain	Keyingham Drain	Keyingham Drain
kirk-beck	Kirk Beck	Kirk Beck
lambrok-stream	Lambrok Stream	Lambrok Stream
lowfield-drain	Lowfield Drain	Lowfield Drain
market-weighton-canal	Market Weighton Canal	Market Weighton Canal
nailsworth-stream	Nailsworth Stream	Nailsworth Stream
new-mill-dike	New Mill Dike	New Mill Dike
old-river-tone	Old River Tone	Old River Tone
ponsandane-stream	Ponsandane Stream	Ponsandane Stream
gouthwaite-reservoir	Gouthwaite Reservoir	Gouthwaite Reservoir
river-tham	River Tham	River Tham
roam-drain	Roam Drain	Roam Drain
small-river-lee	Small River Lee	Small River Lee
stocksfield-burn	Stocksfield Burn	Stocksfield Burn
thirlmere-reservoir	Thirlmere Reservoir	Thirlmere Reservoir
woodborough-brook	Woodborough Brook	Woodborough Brook
wyre-river	Wyre River	Wyre River
